#######
## + ##
##$.$##
## * ##
## * ##
## * ##
#  * ##
#  *  #
#  *  #
###  ##
#######